0000000000000000000000000000000000000
0000000000000000000000000000000000000
0000000000000000000000000000000000000
0000000000000000000000000000000000000
0000000000000000000000000000000000000
0000000000000000000000000000000000000
0000000000000000000000000000000000000
0000000000000000000000000000000000000
0000000000000000000000000000000000000
0000000000000000000000000000000000000
0000000000000000000000000000000000000
0000000000000000000000000000000000000
0000000000000000000000000000000000000
0000000000000000000000000000000000000
0000000000000000000000000000000000000
0000000000000000000000000000000000000
0000000000000000000000000000000000000
0000000000000000000000000000000000000
0000000000000000000000000000000000000
0000000000000000000000000000000000000
0000000000000000000000000000000000000
0000000000000000000000000000000000000
0000000000000000000000000000000110000
0000000000000000000000000000000100000
0000000000000000000000000000000100000
0000000000000000000000000111100100000
0000000000000000000000000000011100000
0000000000000000000000000000000100000
0000000000000000000000000000000100000
0000000011111110000000000000000100000
0000000010000010000000000000000100000
0000000111100011000000000000000100000
0000000111100001000001111111111100000
0000000010011111000000100000001000000
0000000010010000000000100000001000000
0000000011S11111111111110000001100000
0000000000000000000000000000000000000

