00001000000
00000001E10
00011101110
00001000100
01001111100
01001001000
01001001000
01001011000
01111110100
0100S011100
00000000000